#define room01_width 35
#define room01_height 35
static unsigned char room01_bits[] = {
   0xff, 0xff, 0xff, 0xff, 0x07, 0x01, 0x00, 0x00, 0x00, 0x04, 0x01, 0x00,
   0x00, 0x00, 0x04, 0x01, 0x00, 0x00, 0x00, 0x04, 0x01, 0x00, 0x00, 0x00,
   0x04, 0x01, 0x01, 0x00, 0x04, 0x04, 0x01, 0x01, 0x00, 0x04, 0x04, 0x01,
   0x01, 0x00, 0x04, 0x04, 0x01, 0x01, 0x00, 0x04, 0x04, 0x01, 0x01, 0x00,
   0x04, 0x04, 0x01, 0x01, 0x00, 0x04, 0x04, 0x01, 0x01, 0x00, 0x04, 0x04,
   0x01, 0x01, 0x00, 0x04, 0x04, 0x01, 0x01, 0x00, 0x04, 0x04, 0x01, 0x01,
   0x00, 0x04, 0x04, 0x01, 0x01, 0x00, 0x04, 0x04, 0x01, 0x01, 0x00, 0x04,
   0x04, 0x01, 0x01, 0x00, 0x04, 0x04, 0x01, 0x01, 0x00, 0x04, 0x04, 0x01,
   0x01, 0x00, 0x04, 0x04, 0x01, 0x01, 0x00, 0x04, 0x04, 0x01, 0x01, 0x00,
   0x04, 0x04, 0x01, 0x01, 0x00, 0x04, 0x04, 0x01, 0x01, 0x00, 0x04, 0x04,
   0x01, 0x01, 0x00, 0x04, 0x04, 0x01, 0x01, 0x00, 0x04, 0x04, 0x01, 0x01,
   0x00, 0x04, 0x04, 0x01, 0x01, 0x00, 0x04, 0x04, 0x01, 0x01, 0x00, 0x04,
   0x04, 0x01, 0x01, 0x00, 0x04, 0x04, 0x01, 0x00, 0x00, 0x00, 0x04, 0x01,
   0x00, 0x00, 0x00, 0x04, 0x01, 0x00, 0x00, 0x00, 0x04, 0x01, 0x00, 0x00,
   0x00, 0x04, 0xff, 0xff, 0xff, 0xff, 0x07};
