#define room7_width 35
#define room7_height 35
static unsigned char room7_bits[] = {
   0xff, 0xff, 0xff, 0xff, 0x07, 0x01, 0x00, 0x00, 0x00, 0x04, 0x01, 0x00,
   0x00, 0x00, 0x04, 0x01, 0x00, 0x00, 0x00, 0x04, 0x01, 0x00, 0x00, 0x00,
   0x04, 0xe1, 0xff, 0xff, 0x3f, 0x04, 0x01, 0x00, 0x00, 0x00, 0x04, 0x01,
   0x00, 0x00, 0x00, 0x04, 0xe1, 0xff, 0xf8, 0x3f, 0x04, 0x01, 0x80, 0x08,
   0x00, 0x04, 0x01, 0x80, 0x08, 0x00, 0x04, 0x01, 0x80, 0x08, 0x00, 0x04,
   0x01, 0x80, 0x08, 0x00, 0x04, 0x01, 0x80, 0x08, 0x00, 0x04, 0x01, 0x80,
   0x08, 0x00, 0x04, 0x01, 0x80, 0x08, 0x00, 0x04, 0x01, 0x80, 0x08, 0x00,
   0x04, 0x01, 0x80, 0x08, 0x00, 0x04, 0x01, 0x80, 0x08, 0x00, 0x04, 0x01,
   0x80, 0x08, 0x00, 0x04, 0x01, 0x80, 0x08, 0x00, 0x04, 0x01, 0x80, 0x08,
   0x00, 0x04, 0x01, 0x80, 0x08, 0x00, 0x04, 0x01, 0x80, 0x08, 0x00, 0x04,
   0x01, 0x80, 0x08, 0x00, 0x04, 0x01, 0x80, 0x08, 0x00, 0x04, 0x01, 0x80,
   0x08, 0x00, 0x04, 0x01, 0x80, 0x08, 0x00, 0x04, 0x01, 0x80, 0x08, 0x00,
   0x04, 0x01, 0x80, 0x08, 0x00, 0x04, 0x01, 0x00, 0x00, 0x00, 0x04, 0x01,
   0x00, 0x00, 0x00, 0x04, 0x01, 0x00, 0x00, 0x00, 0x04, 0x01, 0x00, 0x00,
   0x00, 0x04, 0xff, 0xff, 0xff, 0xff, 0x07};
