#define room2_width 35
#define room2_height 35
static unsigned char room2_bits[] = {
   0xff, 0xff, 0xff, 0xff, 0x07, 0x01, 0x00, 0x00, 0x00, 0x04, 0x01, 0x00,
   0x00, 0x00, 0x04, 0x01, 0x00, 0x00, 0x00, 0x04, 0x01, 0x00, 0x00, 0x00,
   0x04, 0x01, 0x00, 0x00, 0x00, 0x04, 0xc1, 0xff, 0xff, 0x1f, 0x04, 0x01,
   0x00, 0x02, 0x00, 0x04, 0x01, 0x00, 0x02, 0x00, 0x04, 0x01, 0x00, 0x02,
   0x00, 0x04, 0x01, 0x00, 0x02, 0x00, 0x04, 0x01, 0x00, 0x02, 0x00, 0x04,
   0x01, 0x00, 0x02, 0x00, 0x04, 0x01, 0x00, 0x02, 0x00, 0x04, 0x01, 0x00,
   0x02, 0x00, 0x04, 0x01, 0x00, 0x02, 0x00, 0x04, 0x01, 0x00, 0x02, 0x00,
   0x04, 0x01, 0x00, 0x02, 0x00, 0x04, 0x01, 0x00, 0x02, 0x00, 0x04, 0x01,
   0x00, 0x02, 0x00, 0x04, 0x01, 0x00, 0x02, 0x00, 0x04, 0x01, 0x00, 0x02,
   0x00, 0x04, 0x01, 0x00, 0x02, 0x00, 0x04, 0x01, 0x00, 0x02, 0x00, 0x04,
   0x01, 0x00, 0x02, 0x00, 0x04, 0x01, 0x00, 0x02, 0x00, 0x04, 0x01, 0x00,
   0x02, 0x00, 0x04, 0x01, 0x00, 0x02, 0x00, 0x04, 0x01, 0x00, 0x00, 0x00,
   0x04, 0x01, 0x00, 0x00, 0x00, 0x04, 0x01, 0x00, 0x00, 0x00, 0x04, 0x01,
   0x00, 0x00, 0x00, 0x04, 0x01, 0x00, 0x00, 0x00, 0x04, 0x01, 0x00, 0x00,
   0x00, 0x04, 0xff, 0xff, 0xff, 0xff, 0x07};
