#define room5_width 35
#define room5_height 35
static unsigned char room5_bits[] = {
   0xff, 0xff, 0xff, 0xff, 0x07, 0x01, 0x00, 0x00, 0x00, 0x04, 0x01, 0x00,
   0x00, 0x00, 0x04, 0x01, 0x00, 0x00, 0x00, 0x04, 0x01, 0x00, 0x00, 0x00,
   0x04, 0x01, 0x00, 0x00, 0x00, 0x04, 0x41, 0x00, 0xfe, 0x1f, 0x04, 0x41,
   0x00, 0x00, 0x10, 0x04, 0x41, 0x00, 0x00, 0x10, 0x04, 0x41, 0x00, 0x00,
   0x10, 0x04, 0x41, 0x00, 0x00, 0x10, 0x04, 0x41, 0x00, 0x00, 0x10, 0x04,
   0x41, 0x00, 0x00, 0x10, 0x04, 0x41, 0x00, 0x00, 0x10, 0x04, 0x41, 0x00,
   0x00, 0x10, 0x04, 0x41, 0x00, 0x00, 0x10, 0x04, 0x41, 0x00, 0x00, 0x10,
   0x04, 0x41, 0x00, 0x02, 0x10, 0x04, 0x41, 0x00, 0x00, 0x10, 0x04, 0x41,
   0x00, 0x00, 0x10, 0x04, 0x41, 0x00, 0x00, 0x10, 0x04, 0x41, 0x00, 0x00,
   0x10, 0x04, 0x41, 0x00, 0x00, 0x10, 0x04, 0x41, 0x00, 0x00, 0x10, 0x04,
   0x41, 0x00, 0x00, 0x10, 0x04, 0x41, 0x00, 0x00, 0x10, 0x04, 0x41, 0x00,
   0x00, 0x10, 0x04, 0x41, 0x00, 0x00, 0x10, 0x04, 0xc1, 0xff, 0x03, 0x10,
   0x04, 0x01, 0x00, 0x00, 0x00, 0x04, 0x01, 0x00, 0x00, 0x00, 0x04, 0x01,
   0x00, 0x00, 0x00, 0x04, 0x01, 0x00, 0x00, 0x00, 0x04, 0x01, 0x00, 0x00,
   0x00, 0x04, 0xff, 0xff, 0xff, 0xff, 0x07};
